#Taken from Shattered Europa
NEO = "countries/Neopatria.txt"
NEG = "countries/Negroponte.txt"
EDE = "countries/Edessa.txt"
ATC = "countries/Antioch.txt"
TPL = "countries/TripoliCrusader.txt"
VAN = "countries/Van.txt"

#New
DYR = "countries/DyrrachiumCrusader.txt"
TSL = "countries/ThessalonicaCrusader.txt"
PHP = "countries/PhilippopolisCrusader.txt"
VNA = "countries/VarnaCrusader.txt"
NCP = "countries/NicopolisCrusader.txt"
AMK = "countries/ArmeniacumCrusader.txt"
NCA = "countries/NicaeaCrusader.txt"
PFG = "countries/PaphlagoniaCrusader.txt"
ATO = "countries/AnatoliaCrusader.txt"
TCS = "countries/ThracesiumCrusader.txt"
SAM = "countries/SamusCrusader.txt"
CSN = "countries/CharsianumCrusader.txt"
CLO = "countries/ColoniaCrusader.txt"
CBR = "countries/CibyrraeumCrusader.txt"
MSP = "countries/MesopotamiaCrusader.txt"
TBZ = "countries/TrebizondCrusader.txt"
CRS = "countries/ChersumCrusader.txt"
EPR = "countries/EpirusCrusader.txt"
TSY = "countries/ThessalyCrusader.txt"
OHR = "countries/MacedoniaCrusader.txt"

DAC = "countries/Dacia.txt"
#Imported from Shattered Europa
ALN = "countries/Alans.txt"

#Exarchates
#HSP = "countries/Hesperia.txt"
#GLT = "countries/Galatia.txt"
#KCD = "countries/Karchidon.txt"
#ATL = "countries/Anatolia.txt"
#PSI = "countries/Persis.txt"
#RVN = "countries/Ravenna.txt"
#ABN = "countries/Albion.txt"
#AEG = "countries/Aegyptus.txt"
